69=nice
amber=Did you mean to search for "dentures"?
ambi=Did you mean to search for "dentures"?
am i a joke to you=I plead the Fifth.
choke me daddy=no
choke me, daddy=no
dentures=Did you mean to search for "Amber"?
ernie="cool kid"
kupo=Kupo is a good friend! Tell Kupo I said hello :smile_cat:
love=Baby don't hurt me, don't hurt me, no more... :broken_heart:
muhse=Did you mean to search for "The Real Muhse"?
multispeccing=Blizz: "what's that"
nalti without the u=Because there's no U in "team".
neko=Did you mean to search for "cat"?
nernie="cool kid"
open the pod bay doors=I'm sorry, Dave, I'm afraid I can't do that.
open the pod bay doors, hal=I'm sorry, Dave, I'm afraid I can't do that.
owo=:flushed:
the answer=:four::two:
the answer to life=:four::two:
the answer to life, the universe, and everything=:four::two:
the best huntress=https://raider.io/characters/us/moon-guard/Mourninggale
the bestest gf ever=:ribbon: Ambi :ribbon:
the real muhse=https://raider.io/characters/us/moon-guard/Muhse
thunderfury=:person_facepalming:
thunderfury, blessed blade of the windseeker=:person_facepalming:
travis=Haeva nice day :upside_down_face:
useless=https://gfycat.com/bigsilkybats
uwu=UwU Pizza Delivery, may I take your order?
uwu pizza delivery=UwU Pizza Delivery, may I take your order?
void=Sometimes puns are difficult to *avoid* but Ernie says he'll *annul* my contract if I make too many. :unamused:
what do you do with a drunken sailor=Shave his belly with a rusty razor.
